107
10
0	0	0	0	0	0	0	0	0	0	0	0	0	0	0	0	0	0	0	0	0	0	0	0	0	0	0	0	0	0	0	0	0	0	0	0	0	0	0	0	0	0	0	0	0	0	0	0	0	0	0	0	0	0	0	0	0	0	0	0	0	0	0	0	0	0	0	0	0	0	0	0	0	0	0	0	0	0	0	0	0	0	0	0	0	0	0	0	0	0	0	0	0	0	0	0	0	0	0	0	0	0	0	0	0   0	29
0	0	0	0	0	0	0	0	0	0	0	0	0	0	0	0	0	0	0	0	0	0	0	0	0	0	0	27	28	0	0	0	0	0	0	0	0	0	0	0	0	0	0	0	0	0	0	0	0	0	0	0	0	0	0	0	0	0	0	0	0	0	0	0	0	0	0	0	0	0	0	0	36	37	0	0	0	0	0	0	0	0	0	0	0	0	0	0	0	0	0	0	0	0	0	0	0	0	0	0	0	0	0	0	0	0	29
24	0	0	0	0	0	0	0	0	0	0	0	0	0	0	0	0	0	0	0	0	0	0	23	21	39	6	0	0	0	0	0	0	0	0	25	26	0	0	0	0	0	0	0	0	0	0	0	0	0	0	0	0	0	0	0	0	0	0	0	0	0	0	18  31	17	0	0	0	0	0	0	0	0	0	0	36	37	0	0	0	0	36	37	0	0	0	0	0	0	0	0	0	0	0	0	0	0	0	0	0	0	0	0	0	0	29
22	24	0	0	0	0	0	0	0	0	27	28	0	0	0	0	0	0	0	0	0	0	23	22	22	41	0	0	0	0	0	0	0	25	26	0	0	0	0	0	0	0	0	0	0	0	0	0	0	0	0	0	0	0	0	0	0	0	0	0	0	0	18	31	33	35	0	0	0	0	0	0	0	0	0	0	0	0	0	36	37	0	0	0	0	0	0	0	0	0	0	0	0	0	0	0	0	0	0	0	0	0	0	0	0	0	29
22	22	24	0	0	0	0	0	0	0	0	0	27	28	0	0	0	0	0	0	16	23	22	22	22	41	0	27	28	0	0	25	26	0	0	0	0	0	0	0	36	37	0	0	0	9	11	0	0	0	0	0	36	37	0	0	36	37	0	0	0	18	31	33	33	30	0	0	0	0	0	0	36	37	0	0	0	0	0	0	0	0	0	0	18	31	35	0	0	0	0	0	0	0	0	0	0	0	36	37	0	0	0	0	0   0	29
22	22	22	24	0	0	0	0	27	28	0	0	0	0	0	0	0	0	0	0	23	22	22	22	22	41	0	0	0	0	0	0	0	0	0	0	0	0	0	0	0	0	0	34	31	31	31	31	17	2	0	0	0	0	0	0	0	0	0	0	0	3	33	33	33	30	0	0	0	0	0	0	0	0	0	0	0	0	0	0	0	0	0	0	3	33	30	0	34	35	0   0	0	0	0	0	0	0	0	0	0	0	0	0	0	0	29
22	22	22	22	24	0	0	2	0	0	0	0	0	0	0	0	0	0	0	23	22	22	22	22	22	41	0	0	38	21	21	24	0	0	0	0	0	8	21	39	0	0	0	29	33	33  33	33	31	31	17	0	0	0	0	0	18	31	31	31	31	31	33	33	33	30	0	0	0	0	34	31  31	31	31	31	31	31	31	31	31	31	31	31	31	33	30	0	29	30	0	34	35	0	0	34	32	0	0	10	11	0	0	9	0	0	29
21	21	21	21	21	21	21	21	21	21	39	0	0	38	21	39	0	0	38	22	22	22	22	22	22	41	0	0	40	22	22	22	24	0	16	0	0	23	22	41	0	0	0	29	33	33	33	33	33	33	31	31	31	31	31	31	31	33	33	33	33	33	33	33	33	30	0	0	0	0	29	33	33	33	33	33	33	33	33	33	33	33	33	33	33	33	30	0	29	30	0	29	30	0	0	29	33	31	31	31	31	31	31	31	31	31	31
22	22	22	22	22	22	22	22	22	22	41	0	0	40	22	41	0	0	40	22	22	22	22	22	22	41	0	0	40	22	22	22	22	21	21	21	21	22	22	41	0	0	0	29	33  33	33	33	33	33	33	33	33	33	33	33	33	33	33	33	33	33	33	33	33	30	0	0	0	0	29	33	33	33	33	33	33	33	33	33	33	33	33	33	33	33	30	0	29	30	0	29	30	0	0	29	33	33	33	33	33	33	33	33	33	33	33
22	22	22	22	22	22	22	22	22	22	41	0	0	40	22	41	0	0	40	22	22	22	22	22	22	41	0	0	40	22	22	22	22	22	22	22	22	22	22	41	0	0	0	29	33	33	33	33	33	33	33	33	33	33	33  33	33	33	33	33	33	33	33	33	33	30	0	0	0	0	29	33	33	33	33	33	33  33	33	33	33	33	33	33	33	33	30	0	29	30	0	29	30	0	0	29	33	33	33	33	33	33	33	33	33	33  33