107
10
0	0	0	0	0	0	0	0	0	0	0	0	0	0	0	0	0	0	0	0	0	0	0	0	0	0	0	0	0	0	0	0	0	0	0	0	0	0	0	0	0	0	0	3	22	22	22	22	22	22	22	22	22	22	22	22	22	22	22	22	22	22	22	22	22	22	22	22	22	22	22	22	22	22	22	4	0	0	0	0	0	0	0	0	0	0	0	0	0	0	3	22	22	22	22	22	22	22	22	22	22	22	22	22	22	22	22
0	0	0	0	0	0	0	0	0	0	0	0	0	0	0	0	0	0	0	0	0	0	0	0	0	0	0	0	0	0	0	0	0	0	0	0	0	0	0	0	0	0	0	0	18	22	22	22	22	22	22	22	22	22	22	22	22	22	22	22	19	17	17	17	17	17	17	17	17	17	18	22	22	22	22	4	0	0	0	0	0	0	0	0	0	0	0	0	0	0	0	18	22	22	22	22	22	19	17	17	17	17	17	17	17	18	22
0	0	0	0	0	0	0	0	0	0	0	0	0	0	0	0	0	0	0	0	0	0	0	23	24	25	0	0	0	0	0	0	0	0	0	0	0	0	0	0	0	0	0	0	0	17	17	17	18	22	22	22	22	22	22	22	22	22	22	22	4	0	0	0	0	0	0	0	0	0	0	17	18	22	22	4	0	0	0	0	0	0	0	0	0	0	0	0	0	0	0	0	18	22	22	22	22	4	0	0	0	0	0	0	0	3	22
0	0	0	0	0	0	0	0	0	0	0	0	0	0	0	11	0	0	0	0	0	0	0	0	0	0	0	0	0	0	0	0	0	0	11	0	0	0	0	0	10	0	0	0	0	0	0	0	0	17	17	18	22	22	22	22	22	22	22	19	0	0	10	0	11	0	0	0	0	0	0	0	0	17	17	0	0	0	0	9	0	0	0	0	0	0	0	0	0	0	0	0	0	18	22	22	22	4	0	0	0	0	0	0	0	3	22
0	0	0	0	0	0	0	0	0	0	0	0	11	1	21	21	2	0	0	0	0	23	25	0	0	0	0	0	0	0	0	0	0	23	25	0	0	0	0	23	24	25	0	0	0	9	11	0	0	0	0	0	17	17	17	17	17	17	17	0	0	1	21	21	21	21	2	0	0	0	0	0	0	0	0	0	0	0	0	23	24	25	0	0	1	21	2	0	0	0	0	0	0	0	18	22	22	4	0	0	0	0	0	0	0	3	22
0	0	0	0	23	25	0	0	0	0	1	21	21	21	6	22	4	0	0	11	0	0	10	9	0	0	0	0	0	0	10	0	0	0	0	0	0	11	0	0	0	0	1	21	21	21	21	21	2	0	0	0	9	0	0	0	0	9	0	0	0	3	22	22	22	22	4	0	0	0	0	0	0	0	0	0	0	0	0	0	0	0	0	0	3	22	4	0	0	0	0	0	0	0	0	17	17	0	0	0	0	0	0	0	0	3	22
0	0	9	0	10	0	0	0	0	11	3	22	22	22	22	22	4	1	21	21	21	21	21	21	21	2	0	0	9	1	21	21	2	0	9	1	21	21	21	2	0	0	3	22	22	22	22	22	4	10	0	1	21	2	0	0	1	21	2	11	1	21	6	22	22	22	4	0	0	0	0	10	0	9	0	0	10	9	0	0	11	0	0	1	21	5	21	2	0	0	0	0	0	0	0	0	0	0	0	10	11	0	0	9	0	3	22
21	21	21	21	21	21	21	21	21	21	21	6	22	22	22	22	4	3	22	22	22	22	22	22	5	21	21	21	21	21	6	5	21	21	21	21	6	22	22	4	0	0	3	22	22	22	22	5	21	21	21	21	21	21	21	21	21	21	21	21	21	6	22	22	22	22	4	0	0	1	21	21	21	21	21	21	21	21	21	21	21	21	21	21	6	22	5	21	21	21	21	21	21	21	21	21	21	21	21	21	21	21	21	21	21	21	6
22	22	22	22	22	22	22	22	22	22	22	22	22	22	22	22	4	3	22	22	22	22	22	22	22	22	22	22	22	22	22	22	22	22	22	22	22	22	22	4	0	0	3	22	22	22	22	22	22	22	22	22	22	22	22	22	22	22	22	22	22	22	22	22	22	22	4	0	0	3	22	22	22	22	22	22	22	22	22	22	22	22	22	22	22	22	22	22	22	22	22	22	22	22	22	22	22	22	22	22	22	22	22	22	22	22	22
22	22	22	22	22	22	22	22	22	22	22	22	22	22	22	22	4	3	22	22	22	22	22	22	22	22	22	22	22	22	22	22	22	22	22	22	22	22	22	4	0	0	3	22	22	22	22	22	22	22	22	22	22	22	22	22	22	22	22	22	22	22	22	22	22	22	4	0	0	3	22	22	22	22	22	22	22	22	22	22	22	22	22	22	22	22	22	22	22	22	22	22	22	22	22	22	22	22	22	22	22	22	22	22	22	22	22
